..........................
..........................
..##..%%..##..##..##..%%%%
####..%%..##..##..##..##%%
####..%%..##..##..##..##..
####..%%..##..##..##..##..
####..%%..##@@##..##..%%%%
####..%%..##@@##~~##..##~~
####..%%..##..##..##..##..
####%%%%..........##..%%%%
..~~~####~~~~##~~~~#..%%%%
..........##..##..........
..........##..##..........
##..####..........####..##
@@..####..........####..@@
..........##..##......%%%%
..........###%%%%%%%..%%%%
..##..##..######..##..##..
..##..##..##..##..##..##..
..##..##..##..##..##..##..
..##..##..##..##..##..##..
..##..##...~~~~~~~~~..##..
..##..##..........##..##..
..##..##...####...##..##..
...........#..#...........
...........#..#...........